plant-pathology	horticulture
entomology	horticulture
thermodynamics	chemical-engineering
political-science	social-science
anthropology	social-science
economics	social-science
islamic-world/near-east-history	history
history-of-science,-technology,-and-medicine	history
contemporary-art-history	history
history-of-religions-of-western-origin	history
history-of-religions-of-eastern-origins	history
latin-american-history	history
theatre-history	history
united-states-history	history
diplomatic-history	history
military-history	history
womenâ€™s-history	history
intellectual-history	history
political-history	history
history-of-religion	history
history-of-philosophy	history
gender-history	history
african-history	history
asian-history	history
european-history	history
medieval-history	history
ancient-history	history
social-history	history
economic-history	history
cultural-history	history
archaeological	history
motor-control	communication
air-traffic-control	communication
public-affairs	communication
public-policy	communication
continental-philosophy	philosophy
environmental-microbiology	microbiology
classical-archaeology-and-art-history	classics
classical-literature-and-philology	classics
comparative-literature	classics
ancient-history	classics
ancient-philosophy	classics
public-health	public-affairs
immunology-of-infectious-disease	immunology
food-processing	manufacturing
history-of-religion	theology
psychology-of-movement	psychology
community-psychology	psychology
statistical-methodology	methodologies
nutrition	instrumentation
developmental-biology	cell-biology
biochemistry	cell-biology
paleontology	zoology
parasitology	zoology
endocrinology	zoology
pragmatics	computational-linguistics
population-biology	neuroscience
literature-in-english,-north-america,-ethnic-and-minority	literature-in-english,-north-america
history-of-philosophy	intellectual-history
international-economics	economics
public-economics	economics
behavioral-economics	economics
organic-chemistry	biochemistry
structural-biology	biochemistry
biophysics	biochemistry
genetics	biochemistry
immunology	biochemistry
food-science	nutrition
international-nutrition	nutrition
community-nutrition	nutrition
comparative-nutrition	nutrition
ethics-and-political-philosophy	ethics
literature-in-english,-north-america	science
applied-mechanics	science
logic-and-foundations	science
poultry-science	science
electromagnetics	science
geographic-information-sciences	science
political-science	science
animal-science	science
earth-science	science
wood-science	science
dairy-science	science
atmospheric-sciences	science
materials-science	science
food-science	science
membrane-science	science
physical-science	science
plant-science	science
soil-science	science
life-science	science
forest-sciences	science
cellular-neuroscience	science
behavioral-economics	science
computational-neuroscience	science
developmental-neuroscience	science
systems-neuroscience	science
computer-science	science
molecular-neuroscience	science
crop-sciences	science
environmental-sciences	science
social-science	science
engineering-science	science
cognitive-neuroscience	science
cell-biology	science
metallurgy	science
methodologies	science
engineering	science
humanities	science
geology	science
geophysics	science
zoology	science
mathematics	science
neuroscience	science
microbiology	science
physiology	science
digital-circuits	electrical-engineering
circuits	electrical-engineering
digital-circuits	circuits
medicinal-pharmaceutical-chemistry	chemistry
physical-chemistry	chemistry
materials-chemistry	chemistry
philosophy-of-mind	metaphysics
epistemology	metaphysics
computer-architecture	computer-engineering
compilers	computer-engineering
theatre-history	theatre
astrodynamics	music
ethnomusicology	music
playwriting	music
cultural-history	public-health
environmental-health	public-health
electrical-and-electronics	engineering
condensed-matter-physics	engineering
digital-communications	engineering
physical-science	religion
behavioral-ecology	religion
cancer-biology	molecular-biology
human-geography	geography
human-nutrition	environmental-sciences
atmospheric-sciences	environmental-sciences
paleobiology	environmental-sciences
mass-communication	humanities
international-relations	humanities
english-language-and-literature	humanities
human-geography	humanities
environmental-sciences	humanities
cultural-anthropology	humanities
history	humanities
classics	humanities
geography	humanities
religion	humanities
musicology	humanities
linguistics	humanities
theology	humanities
philosophy	humanities
sociology	humanities
psychology	humanities
cosmology,-relativity,-and-gravity	cosmology
meteorology	oceanography
tribology	applied-mechanics
evolutionary-physiology	physiology
comparative-physiology	physiology
exercise-physiology	physiology
social-history	sociology
plant-pathology	pathology
immunopathology	pathology
fluid-mechanics	physics
condensed-matter-physics	physics
astrophysics-and-astronomy	physics
engineering-physics	physics
mineral-physics	physics
nuclear-physics	physics
quantum-physics	physics
optics	physics
cosmology	physics
metaphysics	physics
geophysics	physics
race-and-ethnicity	analysis
information-systems	analysis
energy-systems	analysis
numerical-analysis	analysis
sociology-of-culture	analysis
phonetics	analysis
toxicology	analysis
pathology	analysis
virology	analysis
comparative-politics	genetics
plant-genetics	genetics
american-politics	political-science
public-administration	public-policy
artificial-intelligence	computer-science
software-engineering	computer-science
computational-biology	computer-science
programming-languages	computer-science
networking	computer-science
algorithms	computer-science
semantics	computer-science
plant-breeding	plant-science
horticulture	plant-science
genomics	plant-science
operational-research	mathematics
ordinary-differential-equations	mathematics
multidisciplinary-design-optimization	mathematics
partial-differential-equations	mathematics
statistics-and-probability	mathematics
scientific-computing	mathematics
non-linear-dynamics	mathematics
dynamical-systems	mathematics
applied-mathematics	mathematics
geometry-and-topology	mathematics
fluid-dynamics	mathematics
numerical-analysis	mathematics
computer-science	mathematics
control-theory	mathematics
number-theory	mathematics
quantum-physics	mathematics
set-theory	mathematics
algebraic-geometry	mathematics
algebra	mathematics
probability	mathematics
analysis	mathematics
physics	mathematics
chemistry	mathematics
nutritional-epidemiology	epidemiology
biostatistics	epidemiology
terrestrial-ecology	ecology
evolutionary-ecology	ecology
behavioral-ecology	ecology
aquatic-ecology	ecology
microbial-ecology	ecology
climate	ecology
transport-phenomena	physical-chemistry
Elements Taxonomy:132.0465.0
Correct: 71
Precision: 0.5378787878787878
Recall: 0.15268817204301074
F1: 0.23785594639865992
